1111111111111111111111111111111111111111111111111111111111111111111111111111111111111111111111
1P00000000000000000000000000000000000000000000000000000000000000000000000000000000000000000001
1000000000000000000000000000000000000000000000000000000000000000000000000000000000000000000001
1000000000000000000000000000000000000000000000000000000000000000000000000000000000000000000001
1000000000111100001111111111111111111100000111111111111111111110000111111111111111111111111001
1000000011111100001111100000000111111100000111110000000011111110000111111111111111111111111001
1000001111111100001110000000000011111100000111000000000001111110000110000000000000000001111001
1000111101111100001100000000000001111100000110000000000000111110000100000000000000000001111001
1001111001111100001000000000000000111100000100000000000000011110000000000000000000000011111001
1000000001111100000000000000000000111100000000000000000000011110000000000000000000000111111001
1000000001111100000000000000000000111100000000000000000000011110000000000000000000001111110001
1000000001111100000000000000000111100000000000000000000011110000000000000000000000011111100001
1000000001111100000000000000011111100000000000000000001111110000000000000000000000111111000001
1000000001111100000000000000000111100000000000000000000011110000000000000000000000111111000001
1000000001111100000000000000000000111100000000000000000000011110000000000000000001111110000001
1000000001111100000000000000000000111100000000000000000000011110000000000000000011111100000001
1000000001111100001000000000000000111100000100000000000000011110000000000000000111111000000001
1000000001111100001100000000000001111100000110000000000000111110000000000000001111110000000001
1000000001111100001000000000000011111100000100000000000001111110000000000000011111100000000001
10000000011111000011110000000001111111000001111CCCCCCCCC11111110000000000000011111100000000001
1000000001111100001111111111111111111100000111111111111111111110000000000000011111100000000001
1000000000000000000000000000000000000000000000000000000000000000000000000000000000000000000001
1000000000000000000000000000000000000000000000000000000000000000000000000000000000000000000001
1000000000000000000000000000000000000000000000000000000000000000000000000000000000000000000001
1000000000000000000000000000000000000000000000000000000000000000000000000000000000000000000001
1000000000000000000000000000000000000000000000000000000000000000000000000000000000000000000001
10000000000000000000000000000000000000000000000000000000000000000000000000000000000000000000E1
1111111111111111111111111111111111111111111111111111111111111111111111111111111111111111111111