111111111111
100000000001
100A000P1101
100001000001
100000000001
1CCC0E000001
100C00000001
101C00000001
111111111111