111111111111111111111111111111111111111111
10000000000000000000000000000000000000A1E1
100000000000000000000000000000000000000101
100000000000000000000000000000000000000101
100000000000000000000000000000000000000101
1C0000000000000000000000000000000000000101
10000000000000A000000000000000000000000001
100000000000000000000000000000000000000001
100000000000000000000000000000000000000001
10000000C000000000000000000000000000000001
100000000000000000000000000000000000000001
100000000000000000000000000000000000000001
1A1000C00000000000000000000000000000000001
1P1000000000000000000000000000000000000001
111111111111111111111111111111111111111111