111111111111111111111111111111111111111111111
1P00001000001000000010000010000010000010010E1
100000100100100001001001001001001001001001001
10000010010010A001001001001001001001001001001
100000100100100001001001001001001001001001001
100000100100100001001001001001001001001001001
100000100100100001001001001001001001001001001
100000100100100001001001001001001001001001001
100000100100100001001001001001001001001001001
100000100100100001001001001001001001001001001
100000100100100001001001001001001001001001001
100000100100100001001001001001001001001001001
100000100100100001001001001001001001001001001
100000100100100001001001001001001001001001001
100000100100100001001001001001001001001001001
100000100100100001001001001001001001001001001
100000100100100001001001001001001001001001001
100000100100100001001001001001001001001001001
100000100100100001001001001001001001001001001
100000100100100001001001001001001001001001001
100000000100000001000001000001000001000000001
111111111111111111111111111111111111111111111