111111111111111111111111111111111111111111111111111111111111
100000P00100000000000000000000000000000000000000000000000001
100000000100000000000000000000000000000000000000000000000001
111111011111111111111111111111111111111111111111111111111111
100000000100000000000000000000000000000000000000000000000001
100000000100000000000000000000000000000000000000000000000001
100000000100000000000000000000000000000000000000000000000001
100000000100000000000000000000000000000000000000000000000001
100000000100000000000000000000000000000000000000000000000001
110011111111111111111111111111111111111111111111111111111111
100000000100000000000000000000000000000000000000000000000001
100000000100000000000000000000000000000000000000000000000001
100000000100000000000000000000000000000000000000000000000001
100000000100000000000000000000000000000000000000000000000001
100000000100000000000000000000000000000000000000000000000001
101111111111111111111111111111111111111111111111111111111111
100000000100000000000000000000000000000000000000000000000001
100000000100000000000000000000000000000000000000000000000001
100000000100000000000000000000000000000000000000000000000001
100000000000000000000000000000000000000000000000000000000001
100000000100000000000000000000000000000000000000000000000001
111111111111111111111111111111111111111111110011111111111111
100000000000000000000000000000000000000000000000000000000001
101111111111111111111111111111111111111111111111111111111111
100000000000000000000000000000000000000000000000000000000001
100000000000000000000000000000000000000000000000000000000001
100000000000000000000000000000000000000000000000000000000001
100000000000000000000000000000000000000000000000000000000001
100000000000000000000000000000000000000000000000000000000001
100000000000000000000000000000000000000000000000000000000001
100000000000000000000000000000000000000000000000000000000001
1000000000000000000000000000000000000000000000000000000000E1
111111111111111111111111111111111111111111111111111111111111
