111111111111111111111111111111111111111111
1111111111111111111000000000000000000000P1
11C000000001111111101111111111111111111111
111111111101111111101111111111111111111111
111111111101111111101111111111111111111111
111111111101111111101111111111111111111111
1110000000000000000C0000000000000000000001
111011111101111111111111111111111111111101
11101111110111111111110000000000000C111101
111011111101111111111101111111111111111101
111011111101111111111101111111111111111101
111011111101111111111101111111111111111101
111011111101111111111101111111111111111101
111011111100000000000000000000000011111101
111011111101111111111101111111111011111101
111011111101111111111101111111111011111101
111011111101111111111101111111111011111101
111011111101111111111101111111111011111101
111C11111101111111111101111111111011111101
1111111111C1111111111101111111111011111101
111111111111111111111101111111111011111101
11C000000000000000000001111111111E111111C1
111111111111111111111111111111111111111111