11111111111111111111111111111111111111111
1A000000000000C00000000000000000000000001
10000000000000000000000000000000000000001
100E000000C000111111100111111111111111001
10000000000000111111100111111111111111001
10000000000111111110000111110011111111001
10000000000111111110000111100011111111001
10000000011111110000000110000011111111001
10000000011111110000000100000011111111001
1000001111111100000C000000000011111110001
10000011111111000000000000000011111110001
1000111111100000000000A000011111111000001
10001111111000000000000000011111111000001
10011111100000000000000001111111000000001
10011111100000000000000001111111000000001
1001111000P0000C0C00000111111100000000001
10011110000000000000000111111100000000001
10011111111111111111100111111100000111001
10011111111111111111100111111100000111001
10011111111111111111100111111100011111001
10011111111111111111100111111100011111001
10000000000000111111100111111101111111001
100000000000001111111001111111C1111111001
10000000C00000111111100000000000000000001
10000000000000111111100000000000000000001
10A00000000000111111100000000000000000001
100000000000000000000000A00000000000000C1
11111111111111111111111111111111111111111