111111111111111111111111111111111111111111111111111111111111111111111111111111111111111111111111111111111111111111111111
100P00000000000000000000000000000000000000000000000111111111111111111100111111111111111111111111111111111000000000000001
100000000000000000000000000000000000000000000000000111111111111111111100111111111111111111111111111111111000000000000001
100000000000000000000000000000000000000000000000000111111111111111111100111111111111111111111111111111111000000000000001
100000000000000000000000000000000000000000000000000111111111111111111100111111111111111111111111111111111000000000000001
100000000000000000000000000000000000000000000000000111111111111111111100111111111111111111111111111111111000000000000001
100000000000000000000000000000000000000000000000000111111111111111111100111111111111111111111111111111111000000000000001
100000000000000000000000000000000000000000000000000111111111111111111100111111111111111111111111111111111000000000000001
100000000000000000000000000000000000000000000000000111111111111111111100111111111111111111111111111111111000000000000001
100000000000000000000000000000000000000000000000000111111111111111111100111111111111111111111111111111111000000000000001
100000000000000000000000000000000000000000000000000111111111111111111100111111111111111111111111111111111000000000000001
100000000000000000000000000000000000000000000000000111111111111111111100111111111111111111111111111111111000000000000001
100000000000000000000000000000000000000000000000000111111111111111111100111111111111111111111111111111111000000000000001
100000000000000000000000000000000000000000000000000111111111111111111100111111111111111111111111111111111000000000000001
100000000000000000000000000000000000000000000000000111111111111111111100111111111111111111111111111111111000000000000001
100000000000000000000000000000000000000000000000000111111111111111111100111111111111111111111111111111111000000000000001
100000000000000000000000000000000000000000000000000111111111111111111100111111111111111111111111111111111000000000000001
100000000000000000000000000000000000000000000000000111111111111111111100111111111111111111111111111111111000000000000001
100000000000000000000000000000000000000000000000000111111111111111111100111111111111111111111111111111111000000000000001
100000000000000000000000000000000000000000000000000111111111111111111100111111111111111111111111111111111000000000000001
100000000000000000000000000000000000000000000000000111111111111111111100111111111111111111111111111111111000000000000001
100000000000000000000000000000000000000000000000000111111111111111111100111111111111111111111111111111111000000000000001
100000000000000000000000000000000000000000000000000111111111111111111100111111111111111111111111111111111000000000000001
100000000000000000000000000000000000000000000000000111111111111111111100111111111111111111111111111111111000000000000001
100000000000000000000000000000000000000000000000000111111111111111111100111111111111111111111111111111111000000000000001
100000000000000000000000000000000000000000000000000111111111111111111100111111111111111111111111111111111000000000000001
100000000000000000000000000000000000000000000000000111111111111111111100111111111111111111111111111111111000000000000001
100000000000000000000000000000000000000000000000000111111111111111111100111111111111111111111111111111111000000000000001
100000000000000000000000000000000000000000000000000111111111111111111100111111111111111111111111111111111000000000000001
100000000000000000000000000000000000000000000000000111111111111111111100111111111111111111111111111111111000000000000001
100000000000000000000000000000000000000000000000000111111111111111111100111111111111111111111111111111111000000000000001
100000000000000000000000000000000000000000000000000111111111111111111100111111111111111111111111111111111000000000000001
100000000000000000000000000000000000000000000000000111111111111111111100111111111111111111111111111111111000000000000001
100000000000000000000000000000000000000000000000000111111111111111111100111111111111111111111111111111111000000000000001
100000000000000000000000000000000000000000000000000111111111111111111100111111111111111111111111111111111000000000000001
100000000000000000000000000000000000000000000000000111111111111111111100111111111111111111111111111111111000000000000001
100000000000000000000000000000000000000000000000000111111111111111111100111111111111111111111111111111111000000000000001
100000000000000000000000000000000000000000000000000111111111111111111100111111111111111111111111111111111000000000000001
100000000000000000000000000000000000000000000000000111111111111111111100111111111111111111111111111111111000000000000001
100000000000000000000000000000000000000000000000000111111111111111111100111111111111111111111111111111111000000000000001
100000000000000000000000000000000000000000000000000111111111111111111100111111111111111111111111111111111000000000000001
100000000000000000000000000000000000000000000000000111111111111111111100111111111111111111111111111111111000000000000001
100000000000000000000000000000000000000000000000000111111111111111111100111111111111111111111111111111111000000000000001
100000000000000000000000000000000000000000000000000111111111111111111100111111111111111111111111111111111000000000000001
100000000000000000000000000000000000000000000000000111111111111111111100111111111111111111111111111111111000000000000001
100000000000000000000000000000000000000000000000000111111111111111111100111111111111111111111111111111111000000000000001
100000000000000000000000000000000000000000000000000111111111111111111100111111111111111111111111111111111000000000000001
100000000000000000000000000000000000000000000000000111111111111111111100111111111111111111111111111111111000000000000001
100000000000000000000000000000000000000000000000000111111111111111111100111111111111111111111111111111111000000000000001
100000000000000000000000000000000000000000000000000111111111111111111100111111111111111111111111111111111000000000000001
100000000000000000000000000000000000000000000000000111111111111111111100111111111111111111111111111111111000000000000001
100000000000000000000000000000000000000000000000000111111111111111111100111111111111111111111111111111111000000000000001
100000000000000000000000000000000000000000000000000111111111111111111100111111111111111111111111111111111000000000000001
100000000000000000000000000000000000000000000000000111111111111111111100111111111111111111111111111111111000000000000001
100000000000000000000000000000000000000000000000000111111111111111111100111111111111111111111111111111111000000000000001
100000000000000000000000000000000000000000000000000111111111111111111100111111111111111111111111111111111000000000000001
100000000000000000000000000000000000000000000000000111111111111111111100111111111111111111111111111111111000000000000001
100000000000000000000000000000000000000000000000000111111111111111111100111111111111111111111111111111111000000000000001
100000000000000000000000000000000000000000000000000111111111111111111100111111111111111111111111111111111000000000000001
100000000000000000000000000000000000000000000000000111111111111111111100111111111111111111111111111111111000000000000001
100000000000000000000000000000000000000000000000000111111111111111111100111111111111111111111111111111111000000000000001
100000000000000000000000000000000000000000000000000111111111111111111100111111111111111111111111111111111000000000000001
10000000000000000E000000000000000000000000000000000111111111111111111100111111111111111111111111111111111000000000000001
100000000000000000000000000000000000000000000000000111111111111111111100111111111111111111111111111111111000000000000001
100000000000000000000000000000000000000000000000000111111111111111111100111111111111111111111111111111111000000000000001
111111111111111111111111111111111111111111111111111111111111111111111111111111111111111111111111111111111111111111111111