11111111111111111111111111111111111111111111111
1P01000000000000000000000A000000000000000000001
10010000000000000000000000000000000000000000001
1001C011111111111111111111111111111111111111C01
1001001E00000000000000A000000000000000000000001
1001001A00000000000000000000000000000A000000001
1001C011111111111111111111111111111111111111111
1001000000000000000000A000000000000000000000001
10010000000000000000000000000000000000000000001
10011111111111111111111111111111111111111111C01
1001000000000000000000A0000000000000000000000A1
10010000000000000000000000000000000000000000001
1001C011111111111111111111111111111111111111111
1001000000000000000A000000000000000000000000001
10010000000000000000000000000000000000000000001
1C0111111111111111111111111111111111111111110C1
10000000000000000000000000000000000000000000001
10A000000000000000000000000000000000A0000000001
11111111111111111111111111111111111111111111111