1111111111
1PC0000001
1C00000001
1000000001
1000000001
10000000E1
1111111111